p	AA
b	AB
t	AC
d	AD
k	AF
g	AG
tS	AH
dZ	AI
f	AJ
v	AK
T	AL
D	AM
s	AN
z	AO
S	AP
Z	AQ
h	AR
m	AS
n	AT
N	AU
l	AV
r\	AW
w	AX
j	AY
W	AZ
6:	BA
i:	BB
I	BC
e	BD
3:	BE
{	BF
6	BG
O	BH
o:	BI
U	BJ
}:	BK
@	BL
{I	BM
Ae	BN
oI	BO
@}	BP
{O	BQ
I@	BR
e:	BS
U@	BT
r	AW
